{
    "rooms": [{
        "floor": ["floor0", "#f0f"],
        "walls": ["wall0", "#ff0"],
        "name": "Courtyard",
        "cells": [
        [1,1,1,1,1,1,1,1,1,"b",1,1,1,1,1,1,1,1,1,1],
        [1,0,0,0,0,0,0,0,0,0,9,0,0,1,0,0,0,0,0,1],
        [1,0,2,9,9,9,9,9,9,9,3,9,9,9,9,9,9,2,0,1],
        [1,0,9,"t0",1,1,1,1,0,0,9,0,0,1,0,0,0,9,0,1],
        [1,0,9,0,0,0,1,1,1,1,1,0,0,0,1,1,0,9,0,1],
        [1,0,9,0,0,0,0,1,0,0,9,0,0,0,0,1,0,9,0,1],
        [1,0,9,0,0,0,0,0,0,0,9,0,0,0,0,0,0,9,1,1],
        [1,0,9,0,0,9,9,9,0,0,9,0,0,0,0,0,0,9,0,1],
        [0,0,9,0,0,1,1,9,0,0,9,0,1,0,1,0,0,9,0,1],
        [0,0,9,0,0,9,1,9,0,0,9,0,0,0,1,0,0,9,0,1],
        ["c",9,9,9,9,9,9,9,9,"p",9,9,9,1,9,9,9,9,9,"d"],
        [0,0,9,0,0,0,0,0,0,0,0,0,0,0,0,0,0,9,0,1],
        [1,0,9,0,0,0,1,1,1,1,1,0,0,0,0,1,0,9,1,1],
        [1,1,9,0,0,0,1,9,9,9,1,0,0,0,0,1,0,9,0,1],
        [1,0,9,0,1,1,1,9,2,9,0,0,0,0,0,1,0,9,1,1],
        [1,0,9,0,0,0,1,1,1,1,1,1,1,0,1,1,0,9,0,1],
        [1,1,9,0,0,0,0,0,0,0,0,0,0,0,0,0,0,9,0,1],
        [1,0,9,0,0,0,0,0,0,0,3,0,0,0,0,0,"t0",9,0,1],
        [1,1,9,9,9,9,9,9,9,9,1,1,9,9,9,9,9,9,0,1],
        [1,0,0,0,0,0,1,0,0,0,0,0,0,1,0,0,0,9,0,1],
        [1,1,1,1,1,1,1,1,1,0,"a",0,1,1,1,1,1,1,1,1]]
    },{
        "floor": ["floor1", "#f0f"],
        "walls": ["wall1", "#0ff"],
        "name": "West Room",
        "link": "c",
        "offset": [-16, -4],
        "cells": [
        [1,1,1,1,1,1,1,1,1,1,1,1,1,1,1,1],
        [1,1,0,0,0,0,0,1,0,0,0,0,0,0,9,1],
        [1,0,9,0,0,0,0,0,0,0,0,0,0,0,9,1],
        [1,0,9,0,1,0,0,0,0,0,0,0,0,1,0,0],
        [1,"t2",9,1,0,0,0,1,0,3,0,1,9,9,9,9],
        [1,0,9,1,0,0,0,1,0,0,0,1,0,0,9,0],
        [1,0,9,0,0,2,0,0,1,0,0,0,0,0,9,0],
        [1,1,0,1,0,0,0,0,0,0,0,0,0,0,9,1],
        [1,1,1,1,1,1,1,1,1,1,1,1,1,1,1,1]]
    },{
        "floor": ["floor0", "#ff0"],
        "walls": ["wall2", "#f0f"],
        "name": "East Room",
        "link": "d",
        "offset": [1, -4],
        "cells": [
        [1,1,1,1,1,1,1,1,1,1,1,1,1,1,1,1],
        [9,1,9,0,0,0,0,0,0,9,1,9,0,0,9,1],
        [9,9,9,0,0,0,0,0,0,0,1,0,0,0,0,1],
        [1,0,0,0,0,0,0,1,0,0,0,0,0,0,0,1],
        [9,0,0,1,1,0,0,1,0,3,0,1,0,1,"t2",1],
        [9,0,0,1,0,0,0,1,0,0,0,1,0,0,0,1],
        [1,9,0,0,0,9,0,0,0,1,0,0,0,0,0,1],
        [1,1,9,0,0,0,0,0,9,1,9,0,0,0,9,1],
        [1,1,1,1,1,1,1,1,1,1,1,1,1,1,1,1]]
    },{
        "floor": ["floor1", "#0f0"],
        "walls": ["wall3", "#ff0"],
        "name": "South Room",
        "link": "a",
        "offset": [-4, 1],
        "cells": [
        [1,1,0,0,0,0,1,1],
        [1,1,1,1,1,1,1,1],
        [1,0,0,0,0,0,0,1],
        [1,0,0,0,0,0,0,1],
        [1,0,0,0,0,0,0,1],
        [1,1,1,1,1,1,1,1],
        [1,0,0,9,2,0,0,1],
        [1,0,0,9,9,0,0,1],
        [1,0,0,9,9,0,0,1],
        [1,0,0,9,9,0,0,1],
        [1,0,0,9,9,0,0,1],
        [1,0,1,9,3,1,0,1],
        [1,0,0,9,9,0,0,1],
        [1,0,0,9,9,"t1",0,1],
        [1,0,0,9,9,0,0,1],
        [1,1,1,1,1,1,1,1]]
    },{
        "floor": ["floor1", "#f00"],
        "walls": ["wall4", "#0ff"],
        "name": "North Room",
        "link": "b",
        "offset": [-4, -16],
        "cells": [
        [1,1,1,1,1,1,1,1],
        [1,0,0,1,1,0,0,1],
        [1,0,9,9,9,9,0,1],
        [1,0,9,9,9,9,0,1],
        [1,1,1,1,1,1,1,1],
        [1,0,0,0,"t1",0,0,1],
        [1,0,0,1,1,0,0,1],
        [1,0,9,9,9,9,0,1],
        [1,0,9,9,9,9,0,1],
        [1,0,0,1,1,0,0,1],
        [1,0,0,0,0,0,0,1],
        [1,0,0,0,3,0,0,1],
        [1,0,9,9,9,9,0,1],
        [1,0,9,9,9,9,0,1],
        [1,0,1,0,0,1,0,1],
        [1,1,1,1,1,1,1,1]]
    }]        
}